abur	aber
ackar	acker
adal	adel
affo	affe
affoltra	affolter
alsō	also
altar	alter
amma	amme
ampfaro	ampfer
angar	anger
angul	angel
angust	angst
ankar	anker
anko	anke
apful	apfel
arkennen	erkennen
arsticken	ersticken
backan	backen
backo	backe
bah	bach
basa	base
belangēn	belangen
bellan	bellen
bergan	bergen
besuohhen	besuchen
betti	bett
betōn	beten
bifindan	befinden
biginnan	beginnen
bikennen	bekennen
bisizzen	besitzen
bisorgēn	besorgen
bistellen	bestellen
blanc	blank
bleh	blech
bleih	bleich
bluot	blut
borgēn	borgen
borto	borte
boto	bote
boum	baum
bracko	bracke
brehhan	brechen
brema	breme
bringan	bringen
bruh	bruch
bruoder	bruder
bruoh	bruch
bruoh	bruch
brōt	brot
bulga	bulge
buog	bug
buoh	buch
dah	dach
dahs	dachs
danc	dank
darbēn	darben
darra	darre
degan	degen
dicki	dick
dihtōn	dichten
dingōn	dingen
dinkil	dinkel
distil	distel
diuten	deuten
doh	doch
dorrēn	dorren
dringan	dringen
dritto	dritte
eban	eben
ebur	eber
eigan	eigen
eitar	eiter
engi	eng
engil	engel
erbo	erbe
erda	erde
esil	esel
essa	esse
estrih	estrich
fah	fach
falla	falle
fallan	fallen
fasal	fasel
fastēn	fasten
fegōn	fegen
fehtan	fechten
felga	felge
felis	fels
fenni	fenn
fenstar	fenster
festi	fest
fiebar	fieber
findan	finden
fingar	finger
finstar	finster
flah	flach
flahs	flachs
flamma	flamme
flasca	flasche
flegil	flegel
flehtan	flechten
flocko	flocke
fluor	flur
fluot	flut
folgēn	folgen
forscōn	forschen
freh	frech
frewen	freuen
fruht	frucht
fuhs	fuchs
funko	funke
gadum	gadem
galla	galle
gangi	gang
garba	garbe
geban	geben
gegin	gegen
gellan	gellen
geltan	gelten
gersta	gerste
gerta	gerte
gesterēn	gestern
gibet	gebet
giburt	geburt
gifallan	gefallen
gilobōn	geloben
ginesan	genesen
giratan	geraten
gisello	geselle
gisiht	gesicht
gispensti	gespenst
gistelli	gestell
gistirni	gestirn
giwalt	gewalt
giwinnan	gewinnen
glocka	glocke
gluot	glut
gota	gote
goumen	gaumen
graban	graben
grillo	grille
guot	gut
gurgula	gurgel
habēn	haben
hackōn	hacken
haftēn	haften
hagal	hagel
halda	halde
halftra	halfter
halla	halle
haltan	halten
hansa	hanse
harfa	harfe
hasal	hasel
haspil	haspel
hederīh	hederich
hefti	heft
heida	heide
heida	heide
heilīg	heilig
heitar	heiter
heizēn	heizen
helfan	helfen
helid	held
hengist	hengst
hera	her
heriberga	herberge
hintar	hinter
hirso	hirse
hodo	hode
holōn	holen
huldī	huld
huof	huf
huot	hut
hōren	hören
igil	igel
impfōn	impfen
inna	inne
innan	innen
intdecken	entdecken
intrinnan	entrinnen
intsagēn	entsagen
intsezzen	entsetzen
intwerfan	entwerfen
irgeban	ergeben
irholōn	erholen
irlouben	erlauben
irquicken	erquicken
irwerban	erwerben
jagōn	jagen
jenēr	jener
joh	joch
kalc	kalk
kamb	kamm
kanna	kanne
kappa	kappe
kegil	kegel
kella	kelle
kellari	keller
kista	kiste
klaga	klage
klebēn	kleben
kletto	klette
klimban	klimmen
klingan	klingen
klingo	klinge
klopfōn	klopfen
klōstar	kloster
knebil	knebel
kneht	knecht
knetan	kneten
knollo	knolle
knouf	knauf
koh	koch
kollāri	koller
kostōn	kosten
koufen	kaufen
krah	krach
kranc	krank
krazzōn	kratzen
kresso	kresse
kresso	kresse
krippa	krippe
krumb	krumm
kruog	krug
krusta	kruste
kundo	kunde
kupfar	kupfer
labōn	laben
ladan	laden
ladōn	laden
lamb	lamm
langōn	langen
lastar	laster
latto	latte
lebēn	leben
leckōn	lecken
ledar	leder
leidōr	leider
leitar	leiter
lernēn	lernen
lesan	lesen
lindi	lind
linsa	linse
liuhten	leuchten
loh	loch
losēn	losen
loub	laub
louft	lauft
luhs	luchs
lunga	lunge
lāge	lage
mado	made
magar	mager
maht	macht
maltar	malter
mandala	mandel
mantal	mantel
mardar	marder
marmul	marmel
masar	maser
massa	masse
matta	matte
meisa	meise
meistar	meister
melc	melk
melda	melde
meldēn	melden
mengan	mengen
merla	merle
mieta	miete
mih	mich
minna	minne
miscen	mischen
mistil	mistel
mittil	mittel
modul	model
morgan	morgen
muntar	munter
muos	mus
muot	mut
muotwillo	mutwille
mutti	mutt
naba	nabe
nagal	nagel
naht	nacht
namo	name
nasa	nase
nascōn	naschen
nebul	nebel
nestila	nestel
nezzen	netzen
noh	noch
noh	noch
nuot	nut
nōtdurft	notdurft
oban	oben
obdah	obdach
ockar	ocker
offan	offen
ottar	otter
palma	palme
peh	pech
pelzōn	pelzen
pfaffo	pfaffe
pfanna	pfanne
pfarra	pfarre
pfeffar	pfeffer
pfistur	pfister
pflastar	pflaster
pflegan	pflegen
pfliht	pflicht
pforta	pforte
platta	platte
polstar	polster
pressa	presse
pressōn	pressen
quappa	quappe
quellan	quellen
ratta	ratte
reba	rebe
reda	rede
redōn	reden
regan	regen
reht	recht
reht	recht
reihhōn	reichen
reisa	reise
rihten	richten
rihtīg	richtig
ringan	ringen
ringila	ringel
rinnan	rinnen
riuten	reuten
rizzen	ritzen
rogan	rogen
roub	raub
roufen	raufen
runga	runge
runsa	runse
rōst	rost
sagēn	sagen
sahs	sachs
salba	salbe
samo	same
scaban	schaben
scaft	schaft
scaltan	schalten
scarbo	scharbe
scollo	scholle
scorf	schorf
scotto	schotte
sculd	schuld
segal	segel
segan	segen
seh	sech
sehs	sechs
seihhen	seichen
seltan	selten
senkil	senkel
sezzen	setzen
siht	sicht
sinfluot	sintflut
singan	singen
sintar	sinter
sippa	sippe
sizzen	sitzen
skenken	schenken
skilling	schilling
skimpfen	schimpfen
sleifen	schleifen
slingen	schlingen
smalz	schmalz
smecken	schmecken
smitzen	schmitzen
sorga	sorge
soum	saum
soum	saum
spaltan	spalten
spanga	spange
spanna	spanne
spannan	spannen
sparēn	sparen
speht	specht
speihha	speiche
speriling	sperling
spiegal	spiegel
spinna	spinne
spinnan	spinnen
springan	springen
spriu	spreu
stadal	stadel
staffal	staffel
stampfōn	stampfen
stanga	stange
stehhan	stechen
steiga	steige
stengil	stengel
sterban	sterben
stiega	stiege
stih	stich
stihhil	stichel
stilli	still
stimma	stimme
stoub	staub
stouf	stauf
strengi	streng
strewen	streuen
strih	strich
striunen	streunen
stuba	stube
stōren	stören
suht	sucht
suohhen	suchen
swarm	schwarm
swarz	schwarz
sweifen	schweifen
swenken	schwenken
swert	schwert
swester	schwester
sāen	säen
tanna	tanne
tapfar	tapfer
tempal	tempel
teppih	teppich
tiligōn	tilgen
titul	titel
tobēn	toben
tohter	tochter
toto	tote
toub	taub
toufen	taufen
tragan	tragen
traht	tracht
trahtōn	trachten
tranc	trank
trebir	treber
treffan	treffen
trestir	trester
tretan	treten
troum	traum
trōst	trost
tuoh	tuch
unmuot	unmut
unrāt	unrat
untan	unten
untar	unter
urloub	urlaub
vespera	vesper
waba	wabe
wagan	wagen
wahs	wachs
wahsan	wachsen
wallan	wallen
wallōn	wallen
waltan	walten
wanga	wange
warnōn	warnen
wartēn	warten
wascan	waschen
wata	wate
watan	waten
weban	weben
wedar	weder
wehsal	wechsel
weibil	weibel
weida	weide
weih	weich
weinōn	weinen
welc	welk
werban	werben
werdan	werden
werfan	werfen
westan	westen
wezzen	wetzen
wicka	wicke
wickilī	wickel
widar	wider
wiht	wicht
wildi	wild
willo	wille
winkan	winken
winkil	winkel
wintar	winter
wipfil	wipfel
wirbil	wirbel
wirtscaft	wirtschaft
wolla	wolle
wuot	wut
wurzala	wurzel
zagal	zagel
zagēn	zagen
zanga	zange
zangar	zanger
zarga	zarge
zeigōn	zeigen
zeihhan	zeichen
zeihhanen	zeichnen
zeisan	zeisen
zelga	zelge
zella	zelle
zelto	zelte
zeltāri	zelter
ziegala	ziegel
zierida	zierde
zierī	zier
zinna	zinne
zirkil	zirkel
zitwar	zitwer
ziug	zeug
zoum	zaum
zubar	zuber
zuht	zucht
zunga	zunge
zwickil	zwickel
ābend	abend
