bluoen	blyːən
scamel	ʃeːməl
weinoːn	vainən
sougen	zɔyɡən
bileggen	baileːɡən
firsuonen	fɛrzøːnən
faldan	faltən
regan	reːɡən
alt	alt
doː	daː
glaz	ɡlat͡sə
soː	zoː
straːza	ʃtraːsə
sleːha	ʃleːə
gougaloːn	ɡaukəln
pfaːwo	pfau
welben	vœlbən
galga	ɡalɡən
bars	baːrʃ
mezzisahs	mɛsər
stroː	ʃtroː
naːtra	natər
engil	ɛŋəl
giliːhnissa	ɡlaixnɪs
brezzitella	breːt͡səl
getriuwi	trɔy
segan	zeːɡən
pfaffo	pfafə
stal	ʃtal
kin	kɪn
noːt	noːt
swarm	ʃvarm
bistaten	bəʃtatən
hanaf	hanf
kraːm	kraːm
tavala	taːfəl
ahsa	aksə
risi	riːzə
herbist	hɛrpst
phluːma	flaum
winkil	vɪŋkəl
kumiː	kʏməl
flasca	flaʃə
skenken	ʃɛŋkən
freh	frɛx
heːrliːh	hɛrlɪx
sliːm	ʃlaim
zehan	t͡seːn
lodo	loːdən
tragan	traːɡən
uːz	aus
gegin	ɡeːɡən
kohhoːn	kɔxən
striunen	ʃtrɔynən
pfending	pfɛnɪx
quaːt	koːt
zweinzug	t͡svant͡sɪx
tunkal	dʊŋkəl
loseːn	loːzən
meio	mai
haz	has
koufen	kaufən
hulla	hʏlə
fuoz	fuːs
zentenaːri	t͡sɛntnər
wiːhsila	vaikzəl
jung	jʊŋ
scuo	ʃuː
amaro	amər
straːla	ʃtraːl
weih	vaix
speriling	ʃpɛrlɪŋ
geil	ɡail
bart	baːrt
ezzih	ɛsɪx
scato	ʃatən
seː	zeː
zeihhanen	t͡saixnən
mast	mast
gazza	ɡasə
doh	dɔx
leitar	laitər
riːfo	raif
anko	aŋkə
quitina	kvɪtə
neman	neːmən
tou	tau
in	ɪnmɪtən
fluot	fluːt
grammatih	ɡramatɪk
burdin	bʏrdə
armuoti	armuːt
salz	zalt͡s
riːf	raif
muoter	mʊtər
hirz	hɪrʃ
scuzzo	ʃʏt͡sə
nahtscato	naxʧatən
bruːt	braut
luft	lʊft
kelter-	kɛlnər
zucken	t͡sʊkən
koːsoːn	koːzən
amsla	amzəl
hirt	hɪrt
ding	dɪŋ
bisengen	zɛŋən
pfiːfoːn	pfaifən
wereːn	ɡəvɛːrən
miːn	main
snabul	ʃnaːbəl
folgeːn	fɔlɡən
biziohan	bət͡siːən
fulliː	fʏlə
zumft	t͡sʊnft
scabo	ʃaːbə
reht	rɛxt
intwisken	ɛntvɪʃən
zuokumft	t͡suːkʊnft
betaloːn	bɛtəln
rost	rɔst
foramunto	foːrmʊnt
mado	maːdə
raːhha	raxə
loh	lɔx
ruoz	ruːs
sigu	ziːk
luːt	laut
lokoːn	lɔkən
last	last
welc	vɛlk
sambaztag	zamstaːk
rizzen	rɪt͡sən
wurfil	vʏrfəl
naht-gala	naxt
nioman	niːmant
waːr	vaːr
screckoːn	ʃrɛkən
scal	ʃal
merken	mɛrkən
kellari	kɛlər
hort	hɔrt
iomeːr	ɪmər
stengil	ʃtɛŋəl
teig	taik
graːo	ɡrau
sehan	zeːən
stoːren	ʃtøːrən
goumo	ɡaumən
fraːga	fraːɡə
gingibero	ɪŋɡvər
riːs	rais
hamustro	hamstər
lesan	leːzən
skiluf	ʃɪlf
skeidan	ʃaidən
marcaːt	markt
palma	palmə
rihten	rɪxtən
stuofa	ʃtuːfə
smiːzan	ʃmaisən
han	haːn
miːla	mailə
firhaltan	fɛrhaltən
irdisc	ɪrdɪʃ
wereːn	vɛːrən
lena	leːnə
sprengen	ʃprɛŋən
sincan	zɪŋkən
argeroːn	ɛrɡərn
nest	nɛst
tiuval	tɔyfəl
skiːt	ʃait
pfalanza	pfalt͡s
harmiliː	hɛrməliːn
wiːz	vais
biwenten	bəvɛndən
angul	aŋəl
wetar	vɛtər
munistiri	mʏnstər
speihha	ʃpaixə
fol	fɔl
flah	flax
giratan	ɡəraːtən
meːr	meːr
uːwila	ɔylə
strecken	ʃtrɛkən
blaːo	blau
widamen	vɪtmən
kampf	kampf
iowedar	jeːdər
wolcan	vɔlkə
swert	ʃveːrt
merkazza	meːrkat͡sə
sterz	ʃtɛrt͡s
bisliozan	bəʃliːsən
wan	vanə
fiuhta	fɪxtə
kreta	krøːtə
roggo	rɔɡən
zubar	t͡suːbər
skiːnan	ʃainən
los	loːs
pflihta	pflɪxt
fior	fiːr
keisur	kaizər
wio	viː
gineːn	ɡɛːnən
heːrisoːn	hɛrʃən
in	heːɡən
fiorteil	fɪrtəl
ziːtiloːso	t͡saitloːzə
riemo	riːmən
triogan	tryːɡən
bintan	bɪndən
huːssuocha	hauszuːxʊŋ
druos	dryːzə
houbit	haupt
uːro	auərɔksə
hoːna	hoːn
ruoba	ryːbə
lenti	lɛndə
laːre	leːr
besmo	beːzən
quellan	kvɛlən
kataro	kaːtər
kella	kɛlə
aːtum	aːtəm
houbitman	hauptman
stupfen	ʃtʊpfən
garba	ɡarbə
swan	ʃvaːn
bleih	blaix
heidan	haidə
harfa	harfə
fater	faːtər
grunt	ɡrʊnt
ladoːn	laːdən
widersahho	viːdərzaxər
kneht	knɛxt
muruwi	mʏrp
morgane	mɔrɡən
fenstar	fɛnstər
zucker	t͡sʊkər
anawalto	anvalt
pfifra	pfɪfərlɪŋ
friːthof	friːthoːf
blas	blas
irdriozan	fɛrdriːsən
wald	valt
anafehtan	anfɛxtən
wintarmaːnoːt	vɪntərmoːnaːt
bruːtigomo	brɔytɪɡam
uzfuoren	ausfyːrən
stih	ʃtɪx
mast	mast
liːh-hamo	laixə
feizt	faist
mitti	mɪtə
tharot	dɔrt
fasteːn	fastən
woneːn	voːnən
hiutu	hɔytə
bar	baːr
wunsc	vʊnʃ
laːo	lau
borst	bɔrstə
wiht	vɪxt
pfaːl	pfaːl
sparwaːri	ʃpɛrbər
knebil	kneːbəl
blecken	blɛkən
westan	vɛstən
gifaːzi	ɡəfɛːs
ram	raːmən
spaːn	ʃpaːn
marmul	marmɔr
frist	frɪst
kappa	kapə
fingar	fɪŋər
draːt	draːt
scuːm	ʃaum
rasco	raʃ
sidalen	ziːdəln
fegoːn	feːɡən
elilenti	eːlɛnt
fuotar	fʊtər
walisc	vɛlʃ
swebeːn	ʃveːbən
kopf	kɔpf
alawaːri	albərn
fora	foːr
impfoːn	ɪmpfən
runzil	rʊnt͡səl
agalstra	ɛʪtər
legen	leːɡən
suːftoːn	zɔyft͡sən
hoːhmuot	hoːxmuːt
tasca	taʃə
kutti	kɛtə
truobi	tryːbə
degan	deːɡən
gilenti	ɡəlɛndə
har	haːr
roːst	rɔst
kostoːn	kɔstən
jagoːn	jaːɡən
waːn	vaːn
sculd	ʃʊlt
saf	zaft
ginuogiː	ɡənuːk
hold	hɔlt
buːr	bauər
gifarto	ɡəfɛːrtə
suːmen	zɔymən
koh	kɔx
iːwa	aibə
rinta	rɪndə
wild	vɪlt
maht	maxt
wanga	vaŋə
liod	liːt
skiozan	ʃiːsən
walloːn	valən
spizzi	ʃpɪt͡s
scaltan	ʃaltən
stihhil	ʃtɪxəl
merla	mɛrlə
aro	aːr
intfindan	ɛmpfɪndən
loːn	loːn
senno	zɛn
loːrber	lɔrbeːr
kalb	kalp
mos	moːs
giwalchen	valkən
diorna	dɪrnə
kerza	kɛrt͡sə
sena	zeːnə
naːjan	nɛːən
leffil	lœfəl
suntaroːn	zɔndərn
truːt	traut
pero	bɛːr
heriberga	hɛrbɛrɡə
wart	vart
werien	veːrən
naːdala	naːdəl
gisello	ɡəzɛlə
huːwiloːn	hɔylən
halftra	halftər
luːtaren	lɔytərn
unraːt	ʊnraːt
braːhhen	prɛːɡən
oːstara	oːstərn
uːzar	ausər
asca	aʃə
giswer	ɡəʃvyːr
bal	bal
armherzi	barmhɛrt͡sɪx
spot	ʃpɔt
redoːn	reːdən
fiːga	faiɡə
nagal	naːɡəl
mieta	miːtə
wir	viːr
grazzo	ɡrɛslɪx
zanga	t͡saŋə
unnan	ɡœnən
liːan	laiən
werd	veːrt
weːnag	veːnɪx
lang	laŋ
scotto	ʃɔtə
sal	zaːl
kalc	kalk
fliːz	flais
gangi	ɡaŋ
jungiling	jʏŋlɪŋ
in	rɪspə
querdar	køːdər
hazlih	hɛslɪx
gislahti	ɡəʃlɛxt
stuːda	ʃtaudə
innan	ɪndɛsən
abgrunt	apɡrʊnt
suːgan	zauɡən
hals	haʪ
hizza	hɪt͡sə
sioh	ziːx
anut	ɛntə
swam	ʃvam
scaz	ʃat͡s
vespera	fɛspər
gimahalo	ɡəmaːl
riːhhi	raix
spor	ʃpɔrn
kurba	kʊrbəl
nasa	naːzə
ledar	leːdər
gimeinsam	ɡəmainzaːm
uːf	auf
bistricken	bəʃtrɪkən
weidalih	vaitlɪx
giweb	ɡəveːbə
gips	ɡɪps
klebeːn	kleːbən
ze	t͡suːrʏk
rediliːh	reːtlɪx
borto	bɔrtə
pfant	pfant
skif	ʃɪf
stackulla	ʃtaxəl
flozza	flɔsə
swaːri	ʃveːr
helfa	hɪlfə
niːgan	naiɡən
gerta	ɡɛrtə
swebal	ʃveːfəl
friosan	friːrən
fridu	friːdə
keva	kɛːfɪx
wintila	vɪndəl
tal	taːl
spiːhhari	ʃpaixər
skinten	ʃɪndən
alruːn	alraun
maːnoːd	moːnaːt
diacan	diːakoːn
adal	aːdəl
barmeːn	ɛrbarmən
scurfen	ʃʏrfən
bodam	boːdən
knetan	kneːtən
gruoba	ɡruːbə
oli	øːl
fihu	viː
balg	balk
lougnen	lɔyɡnən
swellan	ʃvɛlən
enti	ɛndə
naba	naːbə
riohhan	riːxən
wiːo	vaiə
irskephen	ɛrʃœpfən
obaligan	ɔpliːɡən
oːra	oːr
zwibollo	t͡sviːbəl
slegil	ʃleːɡəl
biginnan	bəɡɪnən
iːtal	aitəl
suːbar	zaubər
mezzan	mɛsən
iuweːr	ɔyər
lunga	lʊŋə
dia	vail
muliː	myːlə
smecken	ʃmɛkən
langmuotiːg	laŋmyːtɪx
want	vant
sillaba	zɪlbə
leidoːr	laidər
guot	ɡuːt
stelza	ʃtɛlt͡sə
merha	mɛːrə
kuːski	kɔyʃ
anafaːhan	anfaŋən
buosum	buːzən
skimpfen	ʃɪmpfən
hirso	hɪrzə
arsticken	ɛrʃtɪkən
burg	bʊrk
erbo	ɛrbə
scriːan	ʃraiən
stuot	ʃtuːtə
spannan	ʃpanən
heiliːg	hailɪx
wunt	vʊnt
buhsa	bʏksə
piligriːm	pɪlɡər
birka	bɪrkə
chlanch	klaŋ
blaːsan	blaːzən
raːt	raːt
giskehan	ɡəʃeːən
liob	liːp
ganz	ɡant͡s
ebur	eːbər
sac	zak
weiso	vaizə
dahs	daks
bisturzen	bəʃtʏrt͡sən
scado	ʃaːdən
harz	haːrt͡s
seltan	zɛltən
doːsoːn	toːzən
irgruːwisoːn	ɡrauzən
analih	ɛːnlɪx
kuhhina	kʏxə
spaːti	ʃpɛːt
zwitarn	t͡svɪtər
stillen	ʃtɪlən
wermuota	veːrmuːt
ah	ax
gisezzida	ɡəzɛt͡s
kloːz	kloːs
scaba	ʃaːbə
rammiloːn	raməln
reisa	raizə
bikeːren	bəkeːrən
storah	ʃtɔrx
laz	las
tugan	tauɡən
alba	alp
swenken	ʃvɛŋkən
rouh	raux
fiːra	faiər
ziohan	t͡siːən
hintana	hɪntən
rinnan	rɪnən
noch	toːn
backo	bakə
kienforaha	kiːfər
tegel	tiːɡəl
irwerban	ɛrvɛrbən
reini	rain
felga	fɛlɡə
kiuwan	kauən
piːn	pain
fuogiː	fuːɡə
troum	traum
latto	latə
linsa	lɪnzə
swalawa	ʃvalbə
tranc	traŋk
zuːn	t͡saun
zugil	t͡syːɡəl
stiega	ʃtiːɡə
neben	neːbən
irlouben	ɛrlaubən
ampulla	ampəl
spat	ʃpaːt
sus	zɔnst
walfisc	valfɪʃ
riːho	raiən
nezzen	nɛt͡sən
kraːen	krɛːən
herd	heːrt
hutta	hʏtə
sturo	ʃtøːr
busc	bʊʃ
staːte	ʃteːt
diːhsala	daiksəl
trenken	trɛŋkən
kreiz	krais
holz	hɔlt͡s
kanzella	kant͡səl
bithurfan	bədʏrfən
meizil	maisəl
boroːn	boːrən
luːten	lɔytən
giwis	ɡəvɪs
wurgen	vʏrɡən
ruodar	ruːdər
furh	fʊrxə
ei	ai
hose	hoːzə
feig	faik
milti	mɪlt
findan	fɪndən
pressoːn	prɛsən
swaːgur	ʃvaːɡər
bloːdi	bløːdə
wuosti	vyːst
wesantlih	veːzəntlɪx
muoen	myːən
sarc	zark
buohstab	buːxʃtaːbə
sehs	zɛks
houwan	hauən
wunnimaːnoːd	vɔnəmoːnaːt
kresso	krɛsə
sniːdan	ʃnaidən
kern	kɛrn
dingoːn	dɪŋən
kluft	klʊft
rogan	roːɡən
taːt	taːt
herizogo	hɛrt͡soːk
stehhan	ʃtɛxən
eigan	aiɡən
honag	hoːnɪx
weggi	vɛk
ruora	ruːr
wuohhar	vuːxər
stanga	ʃtaŋə
kunnan	kœnən
zimiːn	t͡sɪmt
habaro	haːfər
thionaːri	diːnər
kizziː	kɪt͡s
lebeːntiːg	leːbɛndɪx
biːga	beːʃ
gerad	ɡəraːdə
muoltra	mʊldə
karag	kark
ackar	akər
roc	rɔk
laboːn	laːbən
polstar	pɔʪtər
giwar	ɡəvaːr
zunten	t͡sʏndən
suohhen	zuːxən
nartha	nardə
gesmiːdi	ɡəʃmaidə
slahan	ʃlaːɡən
meistar	maistər
bluot	blyːtə
scolan	zɔlən
giwennen	ɡəvøːnən
habba	hɪpə
wegan	vɛːɡən
ziːl	t͡sailə
titul	tiːtəl
distil	dɪstəl
unza	ʊnt͡sə
hantscuoh	hanʧuː
kruːzi	krɔyt͡s
heim	haim
briː	brai
swizzen	ʃvɪt͡sən
bruh	brʊx
fallan	falən
bifaːhan	bəfaŋən
stamaloːn	ʃtaməln
hulis	hʏlzə
buhsboum	bʏks
antwurti	antvɔrt
wizzan	vɪsən
suntar	zɔndər
missalingen	mɪslɪŋən
spraːhha	ʃpraːxə
drewen	droːən
pfuzza	pfʏt͡sə
renken.	rɛŋkən
brant	brant
giːsal	ɡaizəl
biost	biːst
huor	huːrə
hamar	hamər
wiga	viːɡə
tagaliːh	tɛːklɪx
hoːren	høːrən
wiːsen	vaizən
wagan	vaːɡən
pfost	pfɔstən
lam	laːm
tunna	tɔnə
unslit	ʊnʃlɪt
briaf	briːf
koloro	koːleːraː
faran	faːrən
leːn	leːən
krucka	krʏkə
louh	laux
rehhanoːn	rɛxnən
wort	vɔrt
blaha	plaːnə
unta	ʊnt
krah	krax
jaːmar	jamər
scutilon	ʃʏtəln
feːhida	feːdə
suozi	zyːs
gibil	ɡiːbəl
hant	hant
meinen	mainən
sant	zant
angar	aŋər
massa	masə
garto	ɡaːrtən
arawiz	ɛrpsə
scerio	ʃɛrɡə
nihhus	nɪks
ruggilinguːn	rʏklɪŋs
waːfan	vafə
mugga	mʏkə
widar	vɪdər
scollo	ʃɔlə
abgot	apɡɔt
irgezzen	ɛrɡœt͡sən
spinnil	ʃpɪndəl
skelmo	ʃɛlm
singan	zɪŋən
giwant	ɡəvant
siːd	zait
waːen	veːən
aːdra	aːdər
zunga	t͡sʊŋə
zittaroːn	t͡sɪtərn
giniozan	ɡəniːsən
first	fɪrst
stahel	ʃtaːl
gaːn	ɡeːən
sterban	ʃtɛrbən
zirzuːsoːn	t͡sauzən
intsageːn	ɛntzaːɡən
liːna	lainə
ano	aːn
zata	t͡sɔtə
stollo	ʃtɔlən
kollaːri	kɔlər
wisula	viːzəl
marg	mark
stelan	ʃteːlən
swelli	ʃvɛlə
langoːn	laŋən
giwizzaniː	ɡəvɪsən
firraː-^^	fɛrnʊnft
arsuohhan	ɛrzuːxən
stilli	ʃtɪl
wickiliː	vɪkəl
spehoːn	ʃpɛːən
krumb	krʊm
scorf	ʃɔrf
ockar	ɔkər
garo	ɡaːr
paradiːs	paradiːs
ahorn	aːhɔrn
manno	mɛnɪklɪx
giozan	ɡiːsən
brust	brʊst
iːngaːn	ainɡeːən
niun	nɔyn
kustor	kʏstər
haːcko	haːkən
huːt	haut
starc	ʃtark
kastanie	kastaːniːə
firslahan	fɛrʃlaːɡən
marca	mark
swintan	ʃvɪndən
winkan	vɪŋkən
strih	ʃtrɪx
boum	baum
warf	vɛrft
bruoten	bryːtən
maːloːn	maːlən
laigo	laiə
antlizzi	antlɪt͡s
galla	ɡalə
sund	zyːdən
grop	ɡroːp
intfaːhan	ɛmpfaŋən
jesan	ɡɛːrən
trog	troːk
turi	tyːr
giwalt	ɡəvalt
sneggo	ʃnɛkə
gelt	ɡɛlt
huːs	haus
klingiloːn	klɪŋəln
stoc	ʃtɔk
eihhurn	aixhœrnxən
psalm[o]	psalm
fluz	flʊs
kleiben	klaibən
grioz	ɡriːs
biquaːmi	bəkveːm
filu	fiːl
giriː	ɡiːr
seiffa	zaifə
lappo	lapən
boc	bɔk
wiːhen	vaiən
horn	hɔrn
zwizziroːn	t͡svɪʧərn
spehhan	ʃprɛxən
kloːstar	kloːstər
fadum	faːdən
erda	eːrdə
suː	zau
sper	ʃpeːr
kluːboːn	klaubən
gidigan	ɡədiːɡən
mara	maːr
halla	halə
bifora	bəfoːr
arabeit	arbait
stiːa	ʃtaiɡə
buliz	pɪlt͡s
dunken	dʏŋkən
sniːwan	ʃnaiən
blat	blat
intsliozan	ɛnʧliːsən
bittar	bɪtər
wolf	vɔlf
uːzslahan	ausʃlaːɡən
stegareif	ʃteːkraif
alamuosan	almoːzən
legar	laːɡər
totoro	dɔtər
hehara	hɛːər
farwa	farbə
zieriː	t͡siːr
umbi	ʊm
struːben	ʃtrɔybən
hincan	hɪŋkən
selb	zɛlbər
kuofa	kuːfə
kolo	koːlə
giskirri	ɡəʃɪr
raːtan	raːtən
leːhanon	leːnən
ungizogan	ʊnɡət͡soːɡən
sat	zat
baːen	bɛːən
heilen	hailən
steigal	ʃtail
kuo	kuː
slahta	ʃlaxt
kranuh	kraːnɪx
bleckazzen	blɪt͡sən
manag	manx
biːna	biːnə
skella	ʃɛlə
rihtiːg	rɪxtɪx
luːs	laus
ein	ain
leːrih	lɛrxə
sweizen	ʃvaisən
hefti	hɛft
leid	lait
tol	tɔl
fah	fax
lindi	lɪnt
atto	ɛtiː
swintiloːn	ʃvɪndəln
haːhsna	haksə
hospitaːlhuːs	hɔspiːtaːl
swiːgeːn	ʃvaiɡən
ruoholoːso	ruːxloːs
furdren	fœrdərn
seita	zaitə
zurnen	t͡sʏrnən
munt	mʊnt
noːtegoːn	nøːtɪɡən
knupfen	knʏpfən
nascoːn	naʃən
mih	mɪx
iuwih	ɔyx
iːlen	ailən
gisunt	ɡəzʊnt
saːliːg	zeːlɪx
kuman	kɔmən
quecsilabar	kvɛkzɪlbər
au	au
iːsan	aizən
roufen	raufən
stil	ʃtiːl
nunna	nɔnə
tobeːn	toːbən
mago	maːɡən
fersna	fɛrzə
gruːeːn	ɡrauən
swermen	ʃvɛrmən
predion	preːdɪɡən
morganegiba	mɔrɡənɡaːbə
herd	heːrt
mist	mɪst
gisamanoːt	ɡəzamt
wollust	vɔlʊst
wolla	vɔlə
tuːba	taubə
gliːzan	ɡlaisən
herza	hɛrt͡s
zwiːg	t͡svaik
urano	uːraːn
bliuwan	blɔyən
wecken	vɛkən
wola	voːl
dah	dax
trouf	traufə
leim	leːm
lebara	leːbər
eiscoːn	haiʃən
slango	ʃlaŋə
lid	liːt
er	eːr
rad	raːt
hadara	haːdər
gerno	ɡɛrn
bitrahtoːn	bətraxtən
maːen	mɛːən
bineman	bəneːmən
braːhha	braːxə
alb	alp
truːreːn	trauərn
rustih	rʏstɪx
priester	priːstər
leist	laist
hewiscrecko	hɔyʃrɛkə
brennen	brɛnən
nuohturn	nʏxtərn
farhiliː	fɛrkəl
slaf	ʃlaf
stum	ʃtʊm
situ	zɪtə
wad	vaːdə
eimbar	aimər
burgo	bʏrɡə
ambahti	amt
kunig	køːnɪx
biwegan	bəveːɡən
prediga	preːdɪxt
trincan	trɪŋkən
hunt	hʊnt
intrinnan	ɛntrɪnən
skiːba	ʃaibə
in	matə
ros	rɔs
eines	ainst
hurt	hʏrdə
gilubida	ɡəlʏpdə
gihradi	ɡəraːdə
roːrah	røːrɪxt
muoza	muːsə
wascan	vaʃən
wiːhrouh	vairaux
einfalt	ainfɛltɪx
bellan	bɛlən
spinnan	ʃpɪnən
zaloːn	t͡saːlən
erstuzzen	ʃtʊt͡sən
ringan	rɪŋən
swiːn	ʃvain
wintbraː	vɪmpər
meldeːn	mɛldən
scaːf	ʃaːf
innan	ɪnən
githehtnissi	ɡədɛxtnɪs
hiːraːt	hairaːt
mel	meːl
gabala	ɡaːbəl
fiur	fɔyər
firiwizzi	foːrvɪt͡s
hella	hœlə
ziːt	t͡sait
uber	yːbər
spriozan	ʃpriːsən
zal	t͡saːl
sleht	ʃlɛxt
gidiːhan	ɡədaiən
zisamane	t͡suːzamən
muːwerf	maulvʊrf
scarbo	ʃarbə
zil	t͡siːl
sliːfan	ʃlaifən
dwerah	t͡svɛrx
petrasile	peːtərziːliːə
suːl	zɔylə
pfiːlaːri	pfailər
sinfluot	zɪntfluːt
riuwa	rɔyə
giruːmo	ɡəraum
zaːh	t͡sɛː
hurst	hɔrst
friːliːh	frailɪx
smiereːn	ʃmiːrən
stam	ʃtam
koroːna	kroːnə
pflegan	pfleːɡən
rind	rɪnt
zins	t͡sɪns
swelgan	ʃvɛlɡən
stophoːn	ʃtɔpfən
heidberi	haidəlbeːrə
stoːla	ʃtoːlaː
urkundi	uːrkʊndə
kevur	kɛːfər
ehir	ɛːrə
loː	loːə
nerien	nɛːrən
kropf	krɔpf
maska	maʃə
felsken	fɛlʃən
einag	ainɪx
knollo	knɔlə
Moːr	moːr
reːren	røːrən
tunihha	tʏnxən
flehtan	flɛxtən
miluh	mɪlx
scanta	ʃandə
kanna	kanə
kisil	kiːzəl
agaleia	akəlai
stucki	ʃtʏk
irstaːn	ɛrʃteːən
girusta	ɡərʏst
ring	rɪŋ
buːtil	bɔytəl
harm	harm
salba	zalbə
krazzoːn	krat͡sən
engi	ɛŋ
einiːg	ainɪɡə
ruota	ruːtə
angust	aŋst
fiːhala	failə
grifil	ɡrɪfəl
scaltjaːr	ʃaltjaːr
eban	eːbən
kegil	keːɡəl
beide	baidə
anagriːfan	anɡraifən
hia	hiːr
fogat	voːkt
nemnen	nɛnən
scuːra	ʃauər
tufstein	tʊf
zapfo	t͡sapfən
muos	muːs
wahsan	vaksən
augusto	auɡʊst
urteil	ʊrtail
kista	kɪstə
kundo	kʊndə
gifatero	ɡəfatər
daːha	toːn
geneste	ɡɪnstər
faːhan	faŋən
scrunta	ʃrʊndə
kloz	klɔt͡s
ribbi	rɪpə
lineːn	leːnən
brunno	brʊnən
forst	fɔrst
spiːsa	ʃpaizə
morsaːri	mœrzər
buːla	bɔylə
fluor	fluːr
havan	haːfən
kletto	klɛtə
mund	mʊnt
pfiːfa	pfaifə
bruːhhan	brauxən
wiːaːri	vaiər
reizen	rait͡sən
bringan	brɪŋən
pfuol	pfuːl
lezzist	lɛt͡st
fal	fal
trota	trɔtə
kramaːri	krɛːmər
leːren	leːrən
sin	zɪn
halda	haldə
steinmez	ʃtainmɛt͡s
diuten	dɔytən
kranc	kraŋk
lerneːn	lɛrnən
kalt	kalt
slito	ʃlɪtən
mangoloːn	maŋəln
biskrenken	bəʃrɛŋkt
bikennen	bəkɛnən
gistatoːn	ɡəʃtatən
lebeːn	leːbən
skiverro	ʃiːfər
kaːsi	kɛːzə
hina	hɪn
stuːhha	ʃtauxə
graban	ɡraːbən
dringan	drɪŋən
muodi	myːdə
loubfrosc	laupfrɔʃ
wisa	viːzə
bracko	brakə
wint	vɪnt
der	deːr
willo	vɪlə
heil	hail
heitar	haitər
kruːt	kraut
sippa	zɪpə
durst	dʊrst
liːb	laip
bruoder	bruːdər
skilihen	ʃiːlən
frewen	frɔyən
emezziːg	ɛmzɪx
soum	zaum
fidula	fiːdəl
ungistuomi	ʊnɡəʃtyːm
ubarwintan	yːbərvɪndən
betti	bɛt
thruken	drʏkən
gestereːn	ɡɛstərn
spiz	ʃpiːs
sumar	zɔmər
nestila	nɛstəl
zan	t͡saːn
sezzen	zɛt͡sən
meist	maist
wegariːh	veːɡərɪx
meior	maiər
ackus	akst
siːn	zain
murmuloːn	mʊrməln
ratih	rɛtɪx
nuz	nʊs
spaltan	ʃpaltən
heilant	hailant
kund	kʊnt
samant	zamt
iːs	ais
ordenlihho	ɔrdəntlɪx
helm	hɛlm
bret	brɛt
seːla	zeːlə
braːtan	braːtən
smaːhi	ʃmaːx
keːren	keːrən
garawen	ɡɛrbən
suːriː	zɔyrə
biscoftuom	bɪstuːm
kuoni	kyːn
arkennen	ɛrkɛnən
teil	tail
rusten	rʏstən
stampfoːn	ʃtampfən
tohter	tɔxtər
missa	mɛsə
tior	tiːr
siːda	zaidə
untartaːn	ʊntərtaːn
zuofirsiht	t͡suːfɛrzɪxt
farn	farn
oba	ɔp
helan	heːlən
stein	ʃtain
ir	iːr
snepfa	ʃnɛpfə
kruːzigoːn	krɔyt͡sɪɡən
scaft	ʃaft
zeihhan	t͡saixən
fellen	fɛlən
scriːban	ʃraibən
gibirgi	ɡəbɪrɡə
buog	buːk
staffal	ʃtafəl
turri	tʊrm
ottar	ɔtər
tenni	tɛnə
lerihha	lɛːrxə
backan	bakən
tingoːn	bədɪŋən
tiof	tiːf
zug	t͡suːk
niowiht	nɪxt
roːa	ruːə
quappa	kvapə
pfiːl	pfail
pfluːma	pflaumə
ruːsa	rɔyzə
breit	brait
munih	mœnx
tropf	trɔpfən
niomeːr	nɪmər
ahto	axt
wellen	vɔlən
weban	veːbən
reba	reːbə
hehhit	hɛxt
betoːn	beːtən
huof	huːf
essa	ɛsə
segansa	zɛnzə
rechen	rɛkən
wituwa	vɪtvə
diomuotiː	deːmuːt
triofan	triːfən
sulza	zʏlt͡sə
billiːh	bɪlɪx
giburtitag	ɡəbuːrt͡staːk
widerwart	viːdərvɛrtɪx
sturm	ʃtʊrm
klaːftra	klaftər
mer	meːr
gisiht	ɡəzɪxt
malz	malt͡s
nidarunga	niːdərʊŋ
brocko	brɔkən
gold	ɡɔlt
irziohan	ɛrt͡siːən
siht	zɪxt
kohhar	kœxər
wintfanga	vɪntfaŋ
hornuz	hɔrnɪsə
koloro	kɔlər
wirtscaft	vɪrʧaft
pfad	pfaːt
kahhala	kaxəl
fiebar	fiːbər
skirm	ʃɪrm
zeːdarboum	t͡seːdər
bliːo	blai
ask	aʃ
zwec	t͡svɛk
truha	truːə
sunnuːnaːband	zɔnaːbənt
aba	ap
ankar	aŋkər
krusta	krʊstə
spanna	ʃpanə
hasalnuz	haːzəlnʊs
pfliht	pflɪxt
klubba	klʊpə
hoːh	hoːx
gans	ɡans
ladan	laːdən
ungimah	ʊnɡəmax
las	laks
haspil	haspəl
segal	zeːɡəl
ingeltan	ɛntɡɛltən
semala	zɛməl
rudio	ryːdə
rant	rant
kelih	kɛlx
eid	ait
foːnno	føːn
lob	loːp
sliːhhan	ʃlaixən
hintberi	hɪmbeːrə
gaganoːti	ɡeːɡənt
bloh	blɔk
spanga	ʃpaŋə
habeːn	haːbən
folc	fɔlk
sag	zaːɡə
muːs	maus
reganbogo	reːɡənboːɡən
strengi	ʃtrɛŋ
mugan	møːɡən
ruom	ruːm
rein	rain
pressa	prɛsə
grieben	ɡriːbə
meineid	mainait
cipres	t͡syːprɛsə
kruog	kruːk
pelzoːn	pɛlt͡sən
stiːgan	ʃtaiɡən
samfti	zanft
heizeːn	hait͡sən
heven	heːbən
nioro	niːrə
nabalo	naːbəl
kamb	kam
niosan	niːzən
harn	harn
zuo	t͡suː
zwiːval	t͡svaifəl
havanari	haːfnər
zin	t͡sɪn
roːsa	roːzə
riːtan	raitən
pfluoc	pfluːk
firgezzan	fɛrɡɛsən
abur	aːbər
ratta	ratə
scorpioːn	skɔrpiːoːn
eːwiːg	eːvɪx
silabar	zɪlbər
huon	huːn
falla	falə
rennen	rɛnən
marzeo	mɛrt͡s
huːba	haubə
tempal	tɛmpəl
uoben	yːbən
biwaroːn	vaːrən
amma	amə
skeran	ʃeːrən
fuːl	faul
ruːneːn	raunən
swester	ʃvɛstər
thulten	dʊldən
brugga	brʏkə
roːr	roːr
joh	jɔx
wurm	vʊrm
toub	taup
anutrehho	ɛnteːrɪx
liːsta	laistə
riːtera	raitər
aːbend	aːbənt
brehhan	brɛxən
haːring	heːrɪŋ
altar	altər
scintala	ʃɪndəl
obaz	oːpst
edili	eːdəl
miːdan	maidən
gruoni	ɡryːn
wildi	vɪlt
tanna	tanə
werdan	veːrdən
wipfil	vɪpfəl
skina	ʃiːnə
darbeːn	darbən
uralt	uːralt
wanast	vanst
muniz	mʏnt͡sə
naːt	naːt
stroum	ʃtroːm
ein	ɛntveːdər
unmuot	ʊnmuːt
noh	nɔx
gegate	ɡatə
ih	ɪx
kriohhan	kriːxən
zam	t͡saːm
gibaːrida	ɡəbɛːrdə
ampfaro	ampfər
tuoh	tuːx
trennen	trɛnən
brunst	brʊnst
ropfoːn	rʊpfən
siuhhiː	zɔyxə
oberoːn	ɛroːbərn
sperren	ʃpɛrən
sticken	ʃtɪkən
liːdan	laidən
elina	ɛlə
wiːla	vailə
skeffil	ʃɛfəl
luhs	lʊks
turtultuːba	tʊrtəltaubə
suntarbaːro	zɔndərbaːr
loufan	laufən
riot	riːt
truckan	trɔkən
reht	rɛxt
ruːta	rautə
skilling	ʃɪlɪŋ
in	ɛntt͡svai
roːra	røːrə
glas	ɡlaːs
grillo	ɡrɪlə
pfarra	pfarə
purpur[a]	pʊrpʊr
muntar	mʊntər
werfan	vɛrfən
nac	nakən
stric	ʃtrɪk
traːgi	trɛːɡə
wizagoːn	vaiszaːɡən
lekza	lɛkt͡siːoːn
scuːr	ʃauər
zi	jʏŋst
baːbes	paːpst
magad	maːkt
kuohho	kuːxən
hazissa	hɛksə
eːrliːh	eːrlɪx
anadaːht	andaxt
klimban	klɪmən
huliː	høːlə
wuntar	vʊndər
chamara	kamər
raban	raːbə
sageːn	zaːɡən
sega	zɛːɡə
bisizzen	bəzɪt͡sən
pflanza	pflant͡sə
geban	ɡeːbən
fluohhoːn	fluːxən
floːh	floː
smal	ʃmaːl
lamb	lam
ana	an
eːwa	eːə
roc	rɔkən
seːro	zeːr
duːsunt	tauzənt
fedara	feːdər
hiuro	hɔyər
festi	fɛst
ort	ɔrt
gidanc	ɡədaŋkə
broːt	broːt
asc	ɛʃə
tuom	doːm
riːban	raibən
narro	nar
gidult	ɡədʊlt
nio	niː
ouga	auɡə
samo	zaːmə
seil	zail
brestan	bɛrstən
bithenken	bədɛŋkən
scoːni	ʃøːn
kerien	keːrən
wer	veːr
sliozan	ʃliːsən
ja	jaː
dorn	dɔrn
muːla	maul
wahheːn	vaxən
dil	diːlə
smirwen	ʃmiːrən
weida	vaidə
bior	biːr
dorf	dɔrf
tumb	dʊm
arm	arm
bitten	bɪtən
waba	vaːbə
lah	laxə
loub	laup
halt	halt
weit	vait
ziug	t͡sɔyk
scultra	ʃʊltər
tisc	tɪʃ
fordroːn	fɔrdərn
sprozzo	ʃprɔsə
baldo	balt
nezzila	nɛsəl
snitalouh	ʃnɪtlaux
knio	kniː
werban	vɛrbən
mandala	mandəl
aːmaht	oːnmaxt
rihtaːri	rɪxtər
draːen	dreːən
sahha	zaxə
bigaːn	bəɡeːən
helid	hɛlt
napf	napf
fackla	fakəl
aːnu	oːnə
snur	ʃnuːr
ruːm	raum
nord	nɔrt
seneːn	zeːnən
hengist	hɛŋst
ahsala	aksəl
fruma	frɔm
giberan	ɡəbɛːrən
gibet	ɡəbeːt
slingen	ʃlɪŋən
dampf	dampf
flec	flɛk
lioht	lɪxt
ruofan	ruːfən
sol	zoːlə
siː	ziː
knopf	knɔpf
ahta	axt
milz	mɪlt͡s
tagawerc	taːkvɛrk
fuoren	fyːrən
ungislaht	ʊnɡəʃlaxt
kel	keːlə
scarpf	ʃarf
wunna	vɔnə
gras	ɡraːs
nezzi	nɛt͡s
giliːh	ɡlaix
raːm	raːm
gireht	ɡərɛxt
forha	føːrə
loc	lɔkə
innigliːh	ɪnɪx
jungfrouwa	jʊŋfrau
lastaroːn	lɛstərn
wala	vaːl
hevo	heːfə
finstar	fɪnstər
sintar	zɪntər
darm	darm
heimo	haimxən
stado	ɡəʃtaːdə
falo	faːl
zirkil	t͡sɪrkəl
menisco	mɛnʃ
wazzar	vasər
ungiwitiri	ʊnɡəvɪtər
spreiten	ʃpraitən
speht	ʃpɛxt
meisa	maizə
braːmberi	brɔmbeːrə
huldiː	hʊlt
senf	zɛnf
gismac	ɡəʃmak
ubbiːg	ʏpɪx
intbintan	ɛntbɪndən
irri	ɪrə
duːm	daumən
ziga;	t͡siːɡə
fruht	fruːxt
ordinoːn	ɔrdnən
striːhhan	ʃtraixən
biotan	biːtən
tor	toːr
weralt	vɛlt
bleh	blɛx
ligen	liːɡən
waso	vaːzən
friː	frai
affo	afə
zimiliːh	t͡siːmlɪx
gimeinida	almɛndə
fliogan	fliːɡən
spareːn	ʃpaːrən
bilidoːn	bɪldən
scuola	ʃuːlə
bank	baŋk
beri	beːrə
zimbar	t͡sɪmər
druːbo	traubə
uːrhano	auərhaːn
zeːha	t͡seːə
bein	bain
suːfan	zaufən
tugund	tuːɡənt
intdecken	ɛntdɛkən
skeitila	ʃaitəl
mord	mɔrt
bilidi	bɪlt
derb	dɛrp
ringila	rɪŋəl
ungihiuri	ʊnɡəhɔyər
zoubar	t͡saubər
kleken	klɛkən
hantaloːn	handəln
geltan	ɡɛltən
masar	maːzər
mespila	mɪspəl
kurbiz	kyːrbɪs
apful	apfəl
nuz	nʊt͡sən
untan	ʊntən
abrello	aprɪl
spec	ʃpɛk
gisaːzi	ɡəzɛːs
irgeban	ɛrɡeːbən
friunt	frɔynt
morgan	mɔrɡən
in	ɛmpoːr
skeltan	ʃɛltən
lust	lʊst
lezzen	fɛrlɛt͡sən
kruːseliːn	krauzə
organa	ɔrɡəl
muːra	mauər
platta	platə
fehtan	fɛxtən
furi	fyːr
fizza	fɪt͡sə
koz	kɔt͡sə
tulli	tʏlə
sturzen	ʃtʏrt͡sən
mahhoːn	maxən
fogal	foːɡəl
nisten	nɪstən
baz	bas
tiuri	tɔyər
sulih	zɔlx
arzaːt	aːrt͡st
eːriːn	eːərn
reːho	reː
wantaloːn	vandəln
eihhila	aixəl
naːh	naː
offan	ɔfən
mantal	mantəl
griːfan	ɡraifən
strang	ʃtraŋ
klopfoːn	klɔpfən
hanenkamb	haːnənkam
scaban	ʃaːbən
kiːmo	kaim
stellen	ʃtɛlən
ruc	rʊk
sleifen	ʃlaifən
warm	varm
korb	kɔrp
irzellen	ɛrt͡sɛːlən
frost	frɔst
fleisc	flaiʃ
giːr	ɡaiər
satul	zatəl
stero	ʃtɛːr
egala	eːɡəl
minza	mɪnt͡sə
gistirni	ɡəʃtɪrn
insnizzen	ʃnɪt͡sən
wizzi	vɪt͡s
tunst	dʊnst
nicchessa	nɪksə
kezzil	kɛsəl
eːra	eːrə
kunst	kʊnst
maːl	maːl
karst	kaːrst
giskiht	ɡəʃɪxtə
unc	ʊŋkə
spriu	ʃprɔy
rato	raːdə
gisindi	ɡəzɪndə
scroːt	ʃroːt
tiligoːn	tɪlɡən
bisamo	biːzaːm
roː	roː
gimah	ɡəmax
geisila	ɡaisəl
fuogen	fyːɡən
smalz	ʃmalt͡s
heiz	hais
siodan	ziːdən
wiːn	vain
mirtilboum	mʏrtə
blenten	blɛndən
biogan	biːɡən
frouwa	frau
forscoːn	fɔrʃən
maːziːg	mɛːsɪx
giwinnan	ɡəvɪnən
bort	bɔrt
simizstein	zɪms
knoto	knoːtən
lastar	lastər
riːzan	raisən
liut	lɔytə
zwiniling	t͡svɪlɪŋ
klein	klain
hof	hoːf
farstaːn	fɛrʃteːən
ouh	aux
gift	ɡɪft
stuol	ʃtuːl
pelliz	pɛlt͡s
liːban	blaibən
most	mɔst
miscen	mɪʃən
wuot	vuːt
nidar	niːdər
gluoen	ɡlyːən
hodo	hoːdə
waganaːri	vaɡnər
zellen	t͡sɛːlən
wiːt	vait
dreskan	drɛʃən
bifindan	bəfɪndən
klobalouh	knoːplaux
dihtoːn	dɪxtən
hintaren	hɪndərn
hemidi	hɛmt
sihhur	zɪxər
weigaroːn	vaiɡərn
biːzan	baisən
scuːvala	ʃaufəl
biːhal	bail
sunta	zʏndə
widar	viːdər
slah	ʃlak
liːn-	laim
namo	naːmə
hintar	hɪntər
spil	ʃpiːl
kussiː	kɪsən
anaboːz	ambɔs
friːatag	fraitaːk
irfaran	ɛrfaːrən
wetti	vɛtə
hunger	hʊŋər
suːr	zauər
peh	pɛx
fetiro	fɛtər
flamma	flamə
boːna	boːnə
stirn	ʃtɪrn
wancoːn	vaŋkən
basa	baːzə
proːsa	proːzaː
fuotar	fʊtər
salm	zalm
heːrschaf	hɛrʃaft
bisorgeːn	bəzɔrɡən
saːt	zaːt
stoːzan	ʃtoːsən
fuolen	fyːlən
butin	bʏtə
biqueman	bəkɔmən
liuhten	lɔyxtən
fravaliː	freːfəl
helfan	hɛlfən
skeliva	ʃɛlfə
elahho	ɛlx
liːhti	laixt
giweri	ɡəveːr
liogan	lyːɡən
intwerfan	ɛntvɛrfən
danna	dan
duː	duː
ekarn	ɛkər
dampho	dampf
gewi	ɡau
flocko	flɔkə
kil	kail
gruozen	ɡryːsən
lilia	liːliːə
heizan	haisən
sibun	ziːbən
firdewen	fɛrdauən
maːno	moːnt
wadal	veːdəl
sliːzan	ʃlaisən
zirc	bət͡sɪrk
heida	haidə
stat	ʃtat
hinta	hɪndə
tupfen	tʊpfən
grad	ɡraːt
hantwerc	hantvɛrk
sweiz	ʃvais
loːz	loːs
braːwa	brauə
baːra	baːrə
arg	ark
trahtoːn	traxtən
bezziro	bɛsər
swendi	ʃvɛndə
scuoba	ʃʊpə
stecko	ʃtɛkən
uːtar	ɔytər
uns	ʊns
stab	ʃtaːp
mengan	mɛŋən
stioban	ʃtiːbən
felliːg	fɛlɪx
bluot	bluːt
bilsa	bɪlzənkraut
zuhtiːg	t͡sʏxtɪx
duncoːn	tʊŋkən
regula	reːɡəl
pferrih	pfɛrx
roub	raup
biː	bai
list	lɪst
giraːti	ɡərɛːt
buozen	byːsən
wahtala	vaxtəl
spiːrboum	ʃpiːrlɪŋ
esil	eːzəl
werd	veːrt
wintar	vɪntər
argwaːn	arkvoːn
taːht	dɔxt
cymbala	t͡sɪmbəl
nein	nain
mirra	mʏrə
kleː	kleː
spiegal	ʃpiːɡəl
henin	hɛnə
rahho	raxən
ofto	ɔft
wintan	vɪndən
skioban	ʃiːbən
bibeːn	beːbən
eih	aixə
wunskiligarta	vʏnʃəlruːtə
struːz	ʃtraus
gurgula	ɡʊrɡəl
giburt	ɡəbuːrt
Kris[t]	krɪst
geduang	t͡svaŋ
zollo	t͡sɔl
stiːg	ʃtaik
lentiː	lɛndə
donar	dɔnər
biscof	bɪʃɔf
anawenten	anvɛndən
rasta	rast
hart	hart
gismaːhtoːn	ʃmaxtən
skimbal	ʃɪməl
riːsahi	raizɪx
folo	foːlən
spinna	ʃpɪnə
sweifen	ʃvaifən
firliosan	fɛrliːrən
lescan	lœʃən
pflastar	pflastər
scoːz	ʃoːs
zuht	t͡sʊxt
opfaroːn	ɔpfərn
maːl	maːl
sunnuːntag	zɔntaːk
hafteːn	haftən
zoum	t͡saum
karcaːri	kɛrkər
laːzan	lasən
bibar	biːbər
bah	bax
rigil	riːɡəl
bougen	bɔyɡən
gistelli	ɡəʃtɛl
fleːhoːn	fleːən
heida	haidə
zaːdal	taːdəl
offanbaːri	ɔfənbaːr
wirt	vɪrt
felis	fɛʪ
toːt	toːt
urloub	uːrlaup
ebah	eːfɔy
faso	faːzər
dorreːn	dɔrən
heːrro	hɛr
oːstan	ɔstən
kuːmo	kaum
slunt	ʃlʊnt
smid	ʃmiːt
borgeːn	bɔrɡən
zageːn	t͡saːɡən
holoːn	hoːlən
jucken	jʊkən
buohha	buːxə
dunni	dʏn
nu	nuːn
quaːla	kvaːl
fledarmuːs	fleːdərmaus
gersta	ɡɛrstə
hrucci	rʏkən
gluot	ɡluːt
waz	vas
wituhopfa	viːdəhɔpf
snel	ʃnɛl
grubiloːn	ɡryːbəln
fuhs	fʊks
frezzan	frɛsən
frisc	frɪʃ
fiːant	faint
roz	rɔt͡s
magar	maːɡər
stumpf	ʃtʊmpf
forahta	fʊrxt
toto	toːtə
falk	falkə
armilo	ɛrməl
scalc	ʃalk
offanliːh	œfəntlɪx
eːr	eːər
melchan	mɛlkən
hegga	hɛkə
perala	pɛrlə
filufraːz	fiːlfraːs
sparro	ʃparən
liːnboum	leːnə
troːst	troːst
notaːri	noːtaːr
bogo	boːɡən
truobisal	tryːpzaːl
man	man
sun	zoːn
diob	diːp
gilouben	ɡlaubən
alsoː	alzoː
weg	veːk
flahs	flaks
daː	daː
buoh	buːx
bifelhan.	bəfeːlən
tuon	tuːn
gimeini	ɡəmain
fremidi	frɛmt
gemaːze	ɡəmɛːs
gota	ɡoːtə
wat	vat
suona	zyːnə
hopfo	hɔpfən
bliːhhan	blaixən
klaga	klaːɡə
nuzzi	nʏt͡sə
zwiski	t͡svɪʃən
warza	vart͡sə
gamiza	ɡɛmzə
duft	dʊft
aːmeiza	aːmaizə
zart	t͡saːrt
louba	laubə
burgaːri	bʏrɡər
wicka	vɪkə
toufen	taufən
stuba	ʃtuːbə
ketina	kɛtə
scama	ʃaːm
ala	aːlə
dionoːst	diːnst
wedar	veːdər
kirihha	kɪrxə
huota	huːt
zeigoːn	t͡saiɡən
finko	fɪŋk
fazzoːn	fasən
fargeltan	fɛrɡɛltən
kreːg	kriːk
balsamo	balzaːm
kraft	kraft
aspa	ɛspə
sorga	zɔrɡə
haltan	haltən
got	ɡɔt
obdah	ɔpdax
strigil	ʃtriːɡəl
balko	balkən
lant	lant
wehhalter	vaxɔldər
graːvo	ɡraːf
decchen	dɛkən
furisto	fʏrst
sunna	zɔnə
jugund	juːɡənt
erbi	ɛrbə
luːtiː	laut
steiga	ʃtaiɡə
reif	raif
wart	vartə
siːn	zain
zopf	t͡sɔpf
natuːra	natuːr
huosto	hʊstən
Satanaːs	zaːtan
funko	fʊŋkə
ginaːda	ɡnaːdə
choːr	koːr
gigiht	ɡɪxt
waːg	voːɡə
hel	hɛl
saːen	zɛːən
irliggen	ɛrliːɡən
kresso	krɛsə
fel	fɛl
riz	rɪs
riːhhi	raix
bistellen	bəʃtɛlən
einlif	ɛlf
pulver	pʊlfər
reda	reːdə
altaːri	altaːr
glat	ɡlat
lenzo;	lɛnt͡s
eːrist	eːrst
jeneːr	jeːnər
kubilo	kyːbəl
werh	vɛrk
malan	maːlən
frosc	frɔʃ
wohha	vɔxə
firsliːzan	fɛrʃlaisən
zorn	t͡sɔrn
oblaːta	oːplaːtə
aruz	eːrt͡s
scutten	ʃʏtən
bruoh	brʊx
kazza	kat͡sə
touwoːn	tauən
giwitiri	ɡəvɪtər
heften	hɛftən
sib	ziːp
forhana	foːrɛlə
zerren	t͡sɛrən
wiːda	vaidə
roːt	roːt
traht	traxt
imbiz	ɪmbɪs
skeida	ʃaidə
scriːn	ʃrain
diːadeːma	diːadeːm
glocka	ɡlɔkə
aːdv.	laizə
gilimphlih	ɡlɪmpflɪx
flegil	fleːɡəl
muotoːn	muːtən
linna	liːniːə
bruːn	braun
riomo	riːmən
naːh	naːx
pfunt	pfʊnt
stunta	ʃtʊndə
trahho	draxə
langsam	laŋzaːm
herta	heːrdə
deser	diːzər
skinco	ʃɪŋkən
fundament	fʊndamɛnt
rehho	rɛxən
hamal	haməl
dionoːn	diːnən
leːra	leːrə
karra	karən
wirz	vʏrt͡sə
arm	arm
halb	halp
weizi	vait͡sən
reigar	raiər
frewida	frɔydə
leib	laip
winta	vɪndə
isila	ɪnzəl
marmul	marməl
heima	haim
sliz	ʃlɪt͡s
bettiliː	beːt
fliozan	fliːsən
strewen	ʃtrɔyən
durftiːg	dʏrftɪx
arka	arxə
eitar	aitər
scouwoːn	ʃauən
obe	ɔp
brunniː	brʏnə
gispurren	ʃpyːrən
scoːnen	ʃoːnən
stara	ʃtaːr
wurzala	vʊrt͡səl
helfantbein	ɛlfənbain
flado	flaːdən
egidehsa	aidɛksə
gast	ɡast
pforta	pfɔrtə
bast	bast
kuri	kyːr
ohso	ɔksə
giloboːn	ɡəloːbən
gibuːida	ɡəbɔydə
fuora	fuːrə
gifallan	ɡəfalən
eiganscaft	aiɡənʃaft
liumunt	lɔymʊnt
driː	drai
gel	ɡɛlp
zella	t͡sɛlə
bolz	bɔlt͡sən
man	man
asco	ɛʃə
popilboum	papəl
kupfar	kʊpfər
truːeːn	trauən
bluoma	bluːmə
zierida	t͡siːrdə
firrecken	fɛrrɛkən
kuoli	kyːl
stiften	ʃtɪftən
tag	taːk
hol	hoːl
sihhila	zɪxəl
managiː	mɛŋə
ginesan	ɡəneːzən
kolbo	kɔlbən
untar	ʊntər
gismogen	ʃmiːɡən
skilt	ʃɪlt
botega	bɔtɪx
wiːb	vaip
spunnifarah	ʃpaːnfɛrkəl
danc	daŋk
igil	iːɡəl
klingo	klɪŋə
aːhta	axt
dwengen	t͡svɛŋən
geːro	ɡeːrə
senten	zɛndən
tocka	dɔkə
fimf	fʏnf
naz	nas
watan	vaːtən
siːta	zaitə
krebaz	kreːps
wuolen	vyːlən
jetan	jɛːtən
muotwillo	muːtvɪlə
unkruːt	ʊnkraut
wallan	valən
brema	breːmə
in	vɛk
ezen	ɛt͡sən
naːmi	anɡəneːm
louga	lauɡə
tretan	treːtən
feili	fail
himil	hɪməl
slaːfan	ʃlaːfən
spuolo	ʃpuːlə
reihhoːn	raixən
kussen	kʏsən
eːvangeːlio	eːvaŋɡeːliːʊm
muozan	mʏsən
oːdi	øːdə
grim	ɡrɪm
derren	dœrən
gistaːn	ɡəʃteːən
kurz	kʊrt͡s
wal	vaːl
springan	ʃprɪŋən
hanafuoz	haːnənfuːs
noːtdurft	noːtdʊrft
wurst	vʊrst
einhurno	ainhɔrn
lucka	lʏkə
biːsa	biːzə
sezzal	zɛsəl
has	haːzə
zol	t͡sɔl
mistil	mɪstəl
karpf	karpfən
heimoːti	haimaːt
gilid	ɡliːt
tilli	dɪl
gimeinida	ɡəmaində
gimuoti	ɡəmyːt
kirs	kɪrʃə
haːhan	hɛŋən
wanne	van
scar	ʃaːr
krampf	krampf
sitih	zɪtɪx
minniro	mɪndər
suːsen	zauzən
eːrwirdig	eːrvʏrdɪx
firziːhan	fɛrt͡saiən
faz	fas
durri	dʏr
io	jeː
aːdv.	klainlɪx
rouboːn	raubən
zi	t͡suːveːɡə
leisten	laistən
berg	bɛrk
in	ɪn
wahs	vaks
stior	ʃtiːr
wenten	vɛndən
tapfar	tapfər
seihhen	zaixən
huːfo	haufən
wolfsmilch	vɔlfsmɪlx
firwiːzan	fɛrvaizən
firdamnon	fɛrdamən
blintsliːh	blɪnʧlaixə
hou	hɔy
luːtar	lautər
lahhan	laxən
seltsaːni	zɛltzaːm
zwickil	t͡svɪkəl
quiti	kɪt
ars	arʃ
kalo	kaːl
ziegala	t͡siːɡəl
zuntra	t͡sʊndər
martyra	martər
forn	fɔrn
weihhiː	vaixə
manoːn	maːnən
mardar	mardər
linta	lɪndə
dennen	deːnən
bergan	bɛrɡən
intleːhanon	ɛntleːnən
pfanna	pfanə
fuːht	fɔyxt
kasto	kastən
luːra	lauər
ioman	jeːmant
kervola	kɛrbəl
senken	zɛŋkən
durfan	dʏrfən
bitherbi	biːdər
sloːz	ʃlɔs
quic	kɛk
klingan	klɪŋən
braht	praxt
wiːhhan	vaixən
pfeffar	pfɛfər
sneːo	ʃneː
ginoːzo;	ɡənɔsə
henken	hɛŋkən
cristalla	krɪstal
siula	zɔylə
krippa	krɪpə
swimman	ʃvɪmən
stincan	ʃtɪŋkən
wehsal	vɛksəl
behhari	bɛxər
griːf	ɡraif
jungiro	jʏŋər
spur	ʃpuːr
gescoːz	ɡəʃɔs
binuz	bɪnzə
teppih	tɛpɪx
in	tan
gisuoh	ɡəzuːx
senkil	zɛŋkəl
strengen	anʃtrɛŋən
geist	ɡaist
zelt	t͡sɛlt
leidag	laidɪx
melda	mɛldə
hera	heːr
garn	ɡarn
morhila	mɔrxəl
moraha	møːrə
dicki	dɪk
ernust	ɛrnst
wezzen	vɛt͡sən
huot	huːt
intsezzen	ɛntzɛt͡sən
dwingan	t͡svɪŋən
rehhan	rɛxən
erila	ɛrlə
farlust	fɛrlʊst
becki	bɛkən
bicken	pɪkən
kiol	kiːl
nevo	nɛfə
swingan	ʃvɪŋən
waːga	vaːɡə
spioz	ʃpiːs
ezzan	ɛsən
striːtan	ʃtraitən
abbat	apt
firherioːn	fɛrheːrən
gispensti	ɡəʃpɛnst
spiːan	ʃpaiən
habuh	haːbɪxt
slaːt	ʃloːt
steg	ʃteːk
gaːho	jɛː
bruoh	brʊx
huf	hʏftə
niːd	nait
scuzzila	ʃʏsəl
laːge	laːɡə
modul	moːdəl
boːsi	bøːzə
ubil	yːbəl
wulst	vʊʪt
leiten	laitən
scaːla	ʃaːlə
inberan	ɛntbeːrən
gaːba	ɡaːbə
wirda	vʏrdə
duruh	dʊrx
wirbil	vɪrbəl
firswenten	fɛrʃvɛndən
zeman	t͡siːmən
saːtila	zatəl
koːl	koːl
stimma	ʃtɪmə
ingagan	ɛntɡeːɡən
spuolen	ʃpyːlən
wiːs	vaizə
scirbi	ʃɛrbə
groːz	ɡroːs
holuntar	hoːlʊndər
walza	valt͡sə
bigriːfan	bəɡraifən
bira	bɪrnə
diutisc	dɔyʧ
blint	blɪnt
hasal	haːzəl
floːz	floːs
stiura	ʃtɔyər
haganbuohha	haːɡəbuːxə
zehho	t͡sɛkə
intuːhhan	tauxən
giswulst	ɡəʃvʊʪt
swerien	ʃvøːrən
skiari	ʃiːr
giswester	ɡəʃvɪstər
besuohhen	bəzuːxən
rebahuon	reːphuːn
buːsc	bauʃ
fers	fɛrs
froː	froː
lewo	løːvə
tuːmiloːn	tauməln
korn	kɔrn
minna	mɪnə
belangeːn	bəlaŋən
fuːst	faust
mittitag	mɪtaːk
wah	veː
irliuteren	ɛrlɔytərn
al	al
kind	kɪnt
ablaːz	aplas
gimah	ɡəmax
ban	ban
spentoːn	ʃpɛndən
irquicken	ɛrkvɪkən
soum	zaum
snuor	ʃnuːr
firsehan	fɛrzeːən
steːn	ʃteːən
nebul	neːbəl
denken	dɛŋkən
gilingan	ɡəlɪŋən
gifederi	ɡəfiːdər
piscizzano	ʃaisən
zispen;	t͡sɪʃən
irholoːn	ɛrhoːlən
stiuz	ʃtais
stift	ʃtɪft
suht	zʊxt
smerza	ʃmɛrt͡s
swangar	ʃvaŋər
warteːn	vartən
noh	nɔx
wer	veːr
mit	pfɪŋstən
ruoren	ryːrən
boto	boːtə
stoub	ʃtaup
jaːr	jaːr
matta	matə
speihhilla	ʃpaixəl
oban	oːbən
hansa	hanzə
zwelif	t͡svœlf
kizziloːn	kɪt͡səln
heri	heːr
haːr	haːr
retten	rɛtən
ahtunga	axtʊŋ
fruo	fryː
sluzzil	ʃlʏsəl
muscula	mʊʃəl
waltan	valtən
ovan	oːfən
missen	mɪsən
guz	ɡʊs
treffan	trɛfən
ringi	ɡərɪŋ
mittil	mɪtəl
aftro	aftər
hackoːn	hakən
bant	bant
buːh	baux
hagal	haːɡəl
swarz	ʃvart͡s
wefs	vɛspə
iːn	ain
filz	fɪlt͡s
britissa	prɪʧə
niuwi	nɔy
braːto	braːtən
ast	ast
einoːti	ainøːdə
ankala	ɛŋkəl
blaːen	blɛːən
nackot	nakt
warnoːn	varnən
maːhen	moːn
leckoːn	lɛkən
hag	haːk
sizzen	zɪt͡sən
zi	t͡suːʃtatən
mit	mɪt
stern	ʃtɛrn
lah	laxə
fliohan	fliːən
gang	ɡaŋ
giburien	ɡəbyːrən
inslupfen	ʃlʏpfən
toːd	toːt
ziːhan	t͡saiən
feld	fɛlt
egida	ɛɡə
liːra	laiər
girihti	ɡərɪxt
blanc	blaŋk
twerg	t͡svɛrk
halm	halm
egga	ɛkə
uːzana	ausən
topf	tɔpf
hirn	hɪrn
wacchar	vakər
fano	faːnə
fullen	fʏlən
ruːh	rau
aːl	aːl
kanzellaːri	kant͡slər
muot	muːt
triːban	traibən
fisc	fɪʃ
odo	oːdər
lantscaf	lanʧaft
bad	baːt
